[
	[0, 0, 0, 0, 0, 0, 0, 0, 0, 0, 0, 0, 0, 0, 0, 0, 0, 0, 0, 0],
	[0, 0, 0, 0, 0, 0, 0, 0, 0, 0, 0, 0, 0, 0, 0, 0, 0, 0, 20, 0],
	[0, 0, 0, 0, 0, 0, 0, 0, 0, 0, 0, 0, 0, 0, 0, 0, 0, 6, 14, 0],
	[0, 0, 0, 0, 0, 0, 0, 0, 0, 0, 0, 0, 0, 0, 0, 0, 0, 14, 0, 0],
	[0, 0, 0, 15, 14, 14, 0, 0, 0, 0, 0, 14, 8, 14, 0, 0, 14, 14, 0, 0],
	[0, 0, 0, 0, 0, 14, 14, 14, 14, 14, 14, 14, 0, 14, 14, 0, 14, 0, 0, 0],
	[0, 0, 0, 0, 0, 0, 0, 0, 14, 0, 0, 0, 0, 0, 14, 14, 14, 0, 0, 0],
	[0, 0, 0, 0, 0, 0, 0, 0, 14, 0, 0, 0, 0, 0, 0, 0, 0, 0, 0, 0],
	[0, 0, 0, 0, 0, 0, 0, 0, 3, 9, 0, 0, 0, 0, 0, 0, 0, 0, 0, 0],
	[0, 0, 0, 0, 14, 14, 0, 0, 0, 10, 14, 0, 0, 0, 0, 0, 0, 0, 0, 0],
	[0, 0, 0, 14, 14, 0, 0, 0, 0, 0, 14, 0, 0, 0, 0, 0, 0, 0, 0, 0],
	[0, 0, 0, 14, 0, 0, 0, 0, 14, 14, 14, 0, 0, 0, 0, 0, 0, 0, 0, 0],
	[0, 0, 0, 14, 14, 14, 0, 0, 14, 0, 14, 0, 0, 0, 0, 0, 0, 0, 0, 0],
	[0, 0, 0, 0, 0, 14, 14, 0, 14, 0, 0, 0, 14, 14, 14, 0, 0, 0, 0, 0],
	[0, 0, 0, 0, 0, 0, 14, 14, 4, 14, 14, 14, 14, 0, 14, 0, 14, 14, 14, 0],
	[0, 0, 0, 0, 0, 0, 14, 0, 14, 0, 0, 0, 0, 0, 14, 14, 14, 0, 14, 0],
	[0, 0, 0, 0, 0, 14, 14, 0, 14, 0, 14, 0, 0, 0, 14, 0, 0, 0, 5, 0],
	[0, 0, 0, 0, 0, 14, 0, 14, 14, 14, 14, 0, 0, 0, 14, 14, 14, 0, 0, 0],
	[0, 0, 0, 0, 0, 0, 0, 0, 0, 0, 0, 0, 0, 0, 0, 0, 0, 0, 0, 0]
]
